
F 141, 230, 90
C 112, 203, 242

NO ./textures/Sunflowers.xpm
SO ./textures/Sunflowers.xpm
WE ./textures/Sunflowers.xpm
EA ./textures/Sunflowers.xpm



1111111111111111111111111111
1000000000000000000000000001
1011111111110111111111111101
1010000000010000000000000101
1010111111010111111111100101
1010100001010000000000100101
1010101111011111111110100101
1010101000010000000010100101
10101010111101111110101S0101
1010101000010000010010100101
1010111111011111011110100101
1010000000010000010000000101
1011111111110111111111111101
1000000000000100000000000001
1011111111111111101111111101
1000000000000000000000000001
1111111111111111111111111111
