
F 58 , 180, 37


NO              ./textures/Boxhorses.xpm



SO             ./textures/home.xpm



WE      ./textures/boxgpt.xpm


E    ./textures/field.xpm


C  112,                                4  , 24

    111111111111111111111111
    1000000000110000000000001
    1000000001110000000000001
    1000000000000000000000001111                111
111111111000000001100000000000001          11111101111
10000000000000001100111111111111          1000000001
1111000011111111100000010001               11111111111
11110000011111 11100000010001
11000000110101  11100000010001
100000000000011110000001000111
10000000000000N00000100010001
11000001110101111101111001111
11110111 1110101 101111010001
11111111111111111111111111111


